1111111111111
1C110000000C1
1011011111101
100001C000001
1C00011111101
10000000C1101
1000111111101
10C000E0110P1
1111111111111